############
#.########.#
#####.######
#.########.#
############